35555555555555555555555555555555555555555555555553
80000000000700000000000000007000000007000000000008
80000000000800000000000000008000000008000000000008
80000000000900000000000000009000000009000000000008
84564560456345555550055555563000000000000000000008
80000000000000000000000000008000000009000000000008
80000000000000000000000000003455555563000000000008
80000000000000000000000000000000000007000000000008
84555556300000000000000000000000000008000000000008
80000000700000000000000000000000000008000000000008
80000000800000000000000000000000000008000000000008
80000000800000000000000000000000000008000000000008
80000000800003530000000000000000000008000000000008
80000000800000033000000000000000000008000000000008
80000000900000003300000000000000000008000000000008
80000000000000000330000000000000000009000000000008
80000000000000000035300000000000000003455563004568
80000000000000000000700000000000000000000007000008
80000000000000000000800000000000000000000008000008
80000000000000000000800000000000000000000008000008
80000000000000000000900000000000000000000008000008
84556004555555555556300000000000000000000008000008
80000000000000000000000000000000000000000009000008
80000000000000000000000000000000000004555563000008
80000000000000000000000000000000000000000000000008
80000000000000000000000000000000000000000000000008
80000000000000000000000000000000000000000000000008
84555555556300045555555555555555630000000000000008
80007000000800000000000000000000070000000000000008
80009000000000000000000000000000080000000000000008
80000000000700000000000000000000090000000000000008
80009000000900000000000000000000000000000000000008
84063455556300000000000000000000000000000000000008
80007000000000000000000000000000070000000345555568
80008000000700000000000000000000080000000700000008
80009000000800000000000000000000080000000900000008
80000000000900000000000000000000090000000000000008
35555555555555555555555555555555555555555555555553