34564564564564564564564564564564564564564564564563
70000000000000000000000000000000000000000000000007
80000000000000000000000000000000000000000000000008
90000000000000000000000000000000000000000000000009
70000000000000000000000000000000000000000000000007
80000000000000000000000000000000000000000000000008
90000000000000000000000000000000000000000000000009
70000000000000000000000000000000000000000000000007
80000000000000000000000000000000000000000000000008
90000000000000000000000000000000000000000000000009
70000000000000000000000000000000000000000000000007
80000000000000000000000000000000000000000000000008
90000000000000000000000000000000000000000000000009
70000000000000000000000000000000000000000000000007
80000000000000000000000000000000000000000000000008
90000000000000000000000000000000000000000000000009
70000000000000000000000000000000000000000000000007
80000000000000000000000000000000000000000000000008
90000000000000000000000000000000000000000000000009
70000000000000000000000000000000000000000000000007
80000000000000000000000000000000000000000000000008
90000000000000000000000000000000000000000000000009
70000000000000000000000000000000000000000000000007
80000000000000000000000000000000000000000000000008
90000000000000000000000000000000000000000000000009
70000000000000000000000000000000000000000000000007
80000000000000000000000000000000000000000000000008
90000000000000000000000000000000000000000000000009
70000000000000000000000000000000000000000000000007
80000000000000000000000000000000000000000000000008
90000000000000000000000000000000000000000000000009
70000000000000000000000000000000000000000000000007
80000000000000000000000000000000000000000000000008
90000000000000000000000000000000000000000000000009
70000000000000000000000000000000000000000000000007
80000000000000000000000000000000000000000000000008
90000000000000000000000000000000000000000000000009
34564564564564564564564564564564564564564564564563