55555555555555555555555555555555555555555555555555
50000000000500000000000000000000000000000000000005
50000000000500000000000000000000000000000000000005
50000000000500000000000000000000000000000000000005
50000000000500000000000000000000000000000000000005
50000000000500000000000000000000000000000000000005
50055555555500000000000000000000000000000000000005
50000000000000000000000000000000000000000000000005
50000000000000000000000000000000000000000000000005
50000000000000000000000000000000000000000000000005
50000000000000000000000000000000000000000000000005
50000000000000000000000000000000000000000000000005
50000000000000000000000000000000000000000000000005
50000000000000000000000000000000000000000000000005
50000000000000000000000000000000000000000000000005
50000000000000000000000000000000000000000000000005
50000000000000000000000000000000000000000000000005
50000000000000000000000000000000000000000000000005
50000000000000000000000000000000000000000000000005
50000000000000000000000000000000000000000000000005
50000000000000000000000000000000000000000000000005
50000000000000000000000000000000000000000000000005
50000000000000000000000000000000000000000000000005
50000000000000000000000000000000000000000000000005
50000000000000000000000000000000000000000000000005
50000000000000000000000000000000000000000000000005
50000000000000000000000000000000000000000000000005
50000000000000000000000000000000000000000000000005
50000000000000000000000000000000000000000000000005
50000000000000000000000000000000000000000000000005
50000000000000000000000000000000000000000000000005
50000000000000000000000000000000000000000000000005
50000000000000000000000000000000000000000000000005
50000000000000000000000000000000000000000000000005
50000000000000000000000000000000000000000000000005
50000000000000000000000000000000000000000000000005
50000000000000000000000000000000000000000000000005
55555555555555555555555555555555555555555555555555
